10305070
11111111
10305070
01000010
10305070
00000000
10305070
00000000