00000000
00000000
05500550
05500550
00000000
00000000
00555500
00500500
00500500
00555500