00000000
11111111
00000000
22222222
00000000
33333333
00000000
44444444
00000000
55555555
